"filename", "language", "JavaScript", "comment", "blank", "total"
"c:\git\tomos_ui\lib\dom\index.js", "JavaScript", 32, 0, 14, 46
"c:\git\tomos_ui\lib\glFrag\Animation.js", "JavaScript", 32, 0, 6, 38
"c:\git\tomos_ui\lib\glFrag\Core.js", "JavaScript", 152, 2, 30, 184
"c:\git\tomos_ui\lib\glFrag\Frag.js", "JavaScript", 32, 1, 9, 42
"c:\git\tomos_ui\lib\glFrag\Renderer.js", "JavaScript", 89, 0, 17, 106
"c:\git\tomos_ui\lib\glFrag\state.js", "JavaScript", 21, 0, 5, 26
"c:\git\tomos_ui\lib\state\index.js", "JavaScript", 24, 0, 4, 28
"c:\git\tomos_ui\lib\theme\index.js", "JavaScript", 67, 3, 25, 95
"c:\git\tomos_ui\lib\util\index.js", "JavaScript", 62, 0, 22, 84
"Total", "-", 511, 6, 132, 649